27
16
0 0 0 0 0 0 0 0 0 0 0 0  0 0 0 0 0 0 0 0  0  0  0  0 0 0 0
0 0 0 0 0 0 0 0 0 0 0 0  0 0 0 0 0 0 0 0  0  0  0  0 0 0 0
0 0 0 0 0 0 0 0 0 0 0 0  0 0 0 0 0 0 0 0  0  0  0  0 0 0 0
0 0 0 0 0 0 0 0 0 0 0 0  0 0 0 0 0 0 0 0  0  0  0  0 0 0 0
0 0 0 0 0 0 0 0 0 0 0 0  0 0 0 0 0 0 0 0  0  0  0  0 0 0 0
0 0 0 0 0 0 0 0 0 0 0 0  0 0 0 0 0 0 0 0  0  0  0  0 0 0 0
0 0 0 0 0 0 0 0 0 0 0 0  0 0 0 0 0 0 0 0  0  0  0  0 0 0 0
0 0 0 0 0 0 0 0 0 0 0 0  0 0 0 0 0 0 0 0  0  0  0  0 0 0 0
0 0 0 0 0 0 0 0 0 0 0 0  0 0 0 0 0 0 0 0  0  0  0  0 0 0 0
0 0 0 0 0 0 0 0 0 0 0 0  0 0 0 0 0 0 0 0  0  0  0  0 0 0 0
0 0 0 0 0 0 0 0 0 0 0 0  0 0 0 0 0 0 0 0  0  0  0  0 0 0 0
0 0 0 0 0 0 0 0 0 0 0 0  0 0 0 0 0 0 0 0  0  0  0  0 0 0 0
7 7 7 7 7 7 7 6 7 7 7 10 7 7 6 7 7 7 9 12 0  0  0  0 0 0 0
1 1 1 1 1 1 1 1 1 1 1 3  1 1 1 1 1 1 2 8  12 0  0  0 0 0 0
4 4 4 4 4 4 4 4 4 4 4 4  4 4 4 4 4 4 5 2  8  12 0  0 0 0 0
4 4 4 4 4 4 4 4 4 4 4 4  4 4 4 4 4 4 4 5  2  8  12 0 0 0 0